AA | A A
AB | A B
AC | A C
AD | A D
AE | A E
AF | A F
AG | A G
AH | A H
AI | A I
AJ | A J
AK | A K
AL | A L
AM | A M
AN | A N
AO | A O
AP | A P
AQ | A Q
AR | A R
AS | A S
AT | A T
AU | A U
AV | A V
AW | A W
AX | A X
AY | A Y
AZ | A Z
BA | B A
BB | B B
BC | B C
BD | B D
BE | B E
BF | B F
BG | B G
BH | B H
BI | B I
BJ | B J
BK | B K
BL | B L
BM | B M
BN | B N
BO | B O
BP | B P
BQ | B Q
BR | B R
BS | B S
BT | B T
BU | B U
BV | B V
BW | B W
BX | B X
BY | B Y
BZ | B Z
CA | C A
CB | C B
CC | C C
CD | C D
CE | C E
CF | C F
CG | C G
CH | C H
CI | C I
CJ | C J
CK | C K
CL | C L
CM | C M
CN | C N
CO | C O
CP | C P
CQ | C Q
CR | C R
CS | C S
CT | C T
CU | C U
CV | C V
CW | C W
CX | C X
CY | C Y
CZ | C Z
DA | D A
DB | D B
DC | D C
DD | D D
DE | D E
DF | D F
DG | D G
DH | D H
DI | D I
DJ | D J
DK | D K
DL | D L
DM | D M
DN | D N
DO | D O
DP | D P
DQ | D Q
DR | D R
DS | D S
DT | D T
DU | D U
DV | D V
DW | D W
DX | D X
DY | D Y
DZ | D Z
EA | E A
EB | E B
EC | E C
ED | E D
EE | E E
EF | E F
EG | E G
EH | E H
EI | E I
EJ | E J
EK | E K
EL | E L
EM | E M
EN | E N
EO | E O
EP | E P
EQ | E Q
ER | E R
ES | E S
ET | E T
EU | E U
EV | E V
EW | E W
EX | E X
EY | E Y
EZ | E Z
FA | F A
FB | F B
FC | F C
FD | F D
FE | F E
FF | F F
FG | F G
FH | F H
FI | F I
FJ | F J
FK | F K
FL | F L
FM | F M
FN | F N
FO | F O
FP | F P
FQ | F Q
FR | F R
FS | F S
FT | F T
FU | F U
FV | F V
FW | F W
FX | F X
FY | F Y
FZ | F Z
GA | G A
GB | G B
GC | G C
GD | G D
GE | G E
GF | G F
GG | G G
GH | G H
GI | G I
GJ | G J
GK | G K
GL | G L
GM | G M
GN | G N
GO | G O
GP | G P
GQ | G Q
GR | G R
GS | G S
GT | G T
GU | G U
GV | G V
GW | G W
GX | G X
GY | G Y
GZ | G Z
HA | H A
HB | H B
HC | H C
HD | H D
HE | H E
HF | H F
HG | H G
HH | H H
HI | H I
HJ | H J
HK | H K
HL | H L
HM | H M
HN | H N
HO | H O
HP | H P
HQ | H Q
HR | H R
HS | H S
HT | H T
HU | H U
HV | H V
HW | H W
HX | H X
HY | H Y
HZ | H Z
IA | I A
IB | I B
IC | I C
ID | I D
IE | I E
IF | I F
IG | I G
IH | I H
II | I I
IJ | I J
IK | I K
IL | I L
IM | I M
IN | I N
IO | I O
IP | I P
IQ | I Q
IR | I R
IS | I S
IT | I T
IU | I U
IV | I V
IW | I W
IX | I X
IY | I Y
IZ | I Z
JA | J A
JB | J B
JC | J C
JD | J D
JE | J E
JF | J F
JG | J G
JH | J H
JI | J I
JJ | J J
JK | J K
JL | J L
JM | J M
JN | J N
JO | J O
JP | J P
JQ | J Q
JR | J R
JS | J S
JT | J T
JU | J U
JV | J V
JW | J W
JX | J X
JY | J Y
JZ | J Z
KA | K A
KB | K B
KC | K C
KD | K D
KE | K E
KF | K F
KG | K G
KH | K H
KI | K I
KJ | K J
KK | K K
KL | K L
KM | K M
KN | K N
KO | K O
KP | K P
KQ | K Q
KR | K R
KS | K S
KT | K T
KU | K U
KV | K V
KW | K W
KX | K X
KY | K Y
KZ | K Z
LA | L A
LB | L B
LC | L C
LD | L D
LE | L E
LF | L F
LG | L G
LH | L H
LI | L I
LJ | L J
LK | L K
LL | L L
LM | L M
LN | L N
LO | L O
LP | L P
LQ | L Q
LR | L R
LS | L S
LT | L T
LU | L U
LV | L V
LW | L W
LX | L X
LY | L Y
LZ | L Z
MA | M A
MB | M B
MC | M C
MD | M D
ME | M E
MF | M F
MG | M G
MH | M H
MI | M I
MJ | M J
MK | M K
ML | M L
MM | M M
MN | M N
MO | M O
MP | M P
MQ | M Q
MR | M R
MS | M S
MT | M T
MU | M U
MV | M V
MW | M W
MX | M X
MY | M Y
MZ | M Z
NA | N A
NB | N B
NC | N C
ND | N D
NE | N E
NF | N F
NG | N G
NH | N H
NI | N I
NJ | N J
NK | N K
NL | N L
NM | N M
NN | N N
NO | N O
NP | N P
NQ | N Q
NR | N R
NS | N S
NT | N T
NU | N U
NV | N V
NW | N W
NX | N X
NY | N Y
NZ | N Z
OA | O A
OB | O B
OC | O C
OD | O D
OE | O E
OF | O F
OG | O G
OH | O H
OI | O I
OJ | O J
OK | O K
OL | O L
OM | O M
ON | O N
OO | O O
OP | O P
OQ | O Q
OR | O R
OS | O S
OT | O T
OU | O U
OV | O V
OW | O W
OX | O X
OY | O Y
OZ | O Z
PA | P A
PB | P B
PC | P C
PD | P D
PE | P E
PF | P F
PG | P G
PH | P H
PI | P I
PJ | P J
PK | P K
PL | P L
PM | P M
PN | P N
PO | P O
PP | P P
PQ | P Q
PR | P R
PS | P S
PT | P T
PU | P U
PV | P V
PW | P W
PX | P X
PY | P Y
PZ | P Z
QA | Q A
QB | Q B
QC | Q C
QD | Q D
QE | Q E
QF | Q F
QG | Q G
QH | Q H
QI | Q I
QJ | Q J
QK | Q K
QL | Q L
QM | Q M
QN | Q N
QO | Q O
QP | Q P
QQ | Q Q
QR | Q R
QS | Q S
QT | Q T
QU | Q U
QV | Q V
QW | Q W
QX | Q X
QY | Q Y
QZ | Q Z
RA | R A
RB | R B
RC | R C
RD | R D
RE | R E
RF | R F
RG | R G
RH | R H
RI | R I
RJ | R J
RK | R K
RL | R L
RM | R M
RN | R N
RO | R O
RP | R P
RQ | R Q
RR | R R
RS | R S
RT | R T
RU | R U
RV | R V
RW | R W
RX | R X
RY | R Y
RZ | R Z
SA | S A
SB | S B
SC | S C
SD | S D
SE | S E
SF | S F
SG | S G
SH | S H
SI | S I
SJ | S J
SK | S K
SL | S L
SM | S M
SN | S N
SO | S O
SP | S P
SQ | S Q
SR | S R
SS | S S
ST | S T
SU | S U
SV | S V
SW | S W
SX | S X
SY | S Y
SZ | S Z
TA | T A
TB | T B
TC | T C
TD | T D
TE | T E
TF | T F
TG | T G
TH | T H
TI | T I
TJ | T J
TK | T K
TL | T L
TM | T M
TN | T N
TO | T O
TP | T P
TQ | T Q
TR | T R
TS | T S
TT | T T
TU | T U
TV | T V
TW | T W
TX | T X
TY | T Y
TZ | T Z
UA | U A
UB | U B
UC | U C
UD | U D
UE | U E
UF | U F
UG | U G
UH | U H
UI | U I
UJ | U J
UK | U K
UL | U L
UM | U M
UN | U N
UO | U O
UP | U P
UQ | U Q
UR | U R
US | U S
UT | U T
UU | U U
UV | U V
UW | U W
UX | U X
UY | U Y
UZ | U Z
VA | V A
VB | V B
VC | V C
VD | V D
VE | V E
VF | V F
VG | V G
VH | V H
VI | V I
VJ | V J
VK | V K
VL | V L
VM | V M
VN | V N
VO | V O
VP | V P
VQ | V Q
VR | V R
VS | V S
VT | V T
VU | V U
VV | V V
VW | V W
VX | V X
VY | V Y
VZ | V Z
WA | W A
WB | W B
WC | W C
WD | W D
WE | W E
WF | W F
WG | W G
WH | W H
WI | W I
WJ | W J
WK | W K
WL | W L
WM | W M
WN | W N
WO | W O
WP | W P
WQ | W Q
WR | W R
WS | W S
WT | W T
WU | W U
WV | W V
WW | W W
WX | W X
WY | W Y
WZ | W Z
XA | X A
XB | X B
XC | X C
XD | X D
XE | X E
XF | X F
XG | X G
XH | X H
XI | X I
XJ | X J
XK | X K
XL | X L
XM | X M
XN | X N
XO | X O
XP | X P
XQ | X Q
XR | X R
XS | X S
XT | X T
XU | X U
XV | X V
XW | X W
XX | X X
XY | X Y
XZ | X Z
YA | Y A
YB | Y B
YC | Y C
YD | Y D
YE | Y E
YF | Y F
YG | Y G
YH | Y H
YI | Y I
YJ | Y J
YK | Y K
YL | Y L
YM | Y M
YN | Y N
YO | Y O
YP | Y P
YQ | Y Q
YR | Y R
YS | Y S
YT | Y T
YU | Y U
YV | Y V
YW | Y W
YX | Y X
YY | Y Y
YZ | Y Z
ZA | Z A
ZB | Z B
ZC | Z C
ZD | Z D
ZE | Z E
ZF | Z F
ZG | Z G
ZH | Z H
ZI | Z I
ZJ | Z J
ZK | Z K
ZL | Z L
ZM | Z M
ZN | Z N
ZO | Z O
ZP | Z P
ZQ | Z Q
ZR | Z R
ZS | Z S
ZT | Z T
ZU | Z U
ZV | Z V
ZW | Z W
ZX | Z X
ZY | Z Y
ZZ | Z Z
